...########################################################################################
......#........#..#.....#....................#........#..............#...........#..#.....#
#..#######..####..#..#######..#######..#..####..####..#..####..#######..#..####..#..####..#
#........#.....#........#.....#........#........#.....#..#........#.....#..#........#..#..#
#..####..####..#..###################..##########..#######..####..####..#############..#..#
#..#..#.......................#.....#..#.....#.....#...........#..#.......................#
####..#..####..#############..#..#..#..####..#############..####..#..####..##########..####
#..#........#..............#.....#..#...........#..#..#..#.....#........#........#..#..#..#
#..#..#############..#######..#######..#######..#..#..#..####..#######..#######..#..#..#..#
#.....#..#.....#..#.....#.....#..#........#.....#...........#..#.....#..#.....#.....#.....#
#######..####..#..#..####..####..#..##########..#..#..####..#######..####..####..#######..#
#...........#..#........#..#.................#.....#..#..#...........#.....#...........#..#
#..#..#..####..##########..##########..##########..####..#######..####..####..##########..#
#..#..#........#..#..#........#.....#..#..#........#..#.....#..#..#.....#.....#.....#.....#
#..####..#..####..#..####..#######..#..#..#..#..####..####..#..#######..#..#######..####..#
#.....#..#..#..#.....#..#.....#...........#..#..#..............#.....#.....#..#........#..#
####..#######..#..####..#..#..##########..#######..#..#######..#..#..#######..####..####..#
#.....#..#..............#..#.....#..............#..#........#..#..#..#....................#
####..#..#..###################..#..####..#######..#..####..####..####..#######..#..#..####
#.....#.....#........#.................#........#..#.....#.....#..#..#........#..#..#..#..#
####..####..#..#############..#######..#..####..#..#######..#..#..#..####..####..####..#..#
#.................#..............#..#..#.....#.....#........#.................#..#........#
####..####..####..####..#######..#..###################..#######..#######..#..#######..#..#
#.....#..#..#..#..#........#.....#.....#...........#........#..#..#.....#..#..#.....#..#..#
####..#..####..##########..#######..####..#..####..####..####..#..#..##########..#######..#
#..#..#.....#.....#........#.....#........#.....#.....#.....#........#........#..#.....#..#
#..#..####..#..#..#..#..####..#..####..#..#..###############################..#..####..#..#
#..............#.....#..#.....#........#..#.....#...........#..#..#........#........#.....#
####..#..##########..#..#..#..#..#..#..#..##########..#..#..#..#..#..#..#..####..#######..#
#.....#..#.....#..#..#.....#..#..#..#..#..#...........#..#..#.....#..#..#...........#.....#
#..####..####..#..#..#######..#..####..#############..##########..####..#######..##########
#.....#...........#..#.....#..#..#........#..#..#.............................#.....#.....#
#..#..#######..####..#..####..#############..#..#..#..#..#######..################..####..#
#..#..#..#........#.....#...........#...........#..#..#........#.....#.....#.....#........#
#..#..#..###################..#############..##########..##########..####..####..#..#..####
#..#.....#.....#..#.....#..#.....#.....#.....#.....#........#..............#..#.....#..#..#
####..####..#..#..#..####..#######..####..#..####..#..#..#..#############..#..#######..#..#
#........#..#..#..#........#..#..#.....#..#.....#.....#..#..#........#..#.....#...........#
####..#######..#..#######..#..#..#..##########..####..#######..#..####..#..##########..#..#
#..#.....#.......................#.....#....................#..#..#........#.....#.....#..#
#..####..#..####..####..####..####..#..#..#..#..#######..####..#..####..#..#..#..##########
#........#..#.....#........#..#.....#.....#..#..#........#..#..#........#.....#..#........#
#..#..####..#..#######..################..#..#######..#..#..#######..####..####..#..####..#
#..#..#.....#..#..............#........#..#..#........#.....#.....#.....#..#...........#..#
####..#..#..#######..####..#..####..#..#######..##########..#..#######..################..#
#.....#..#.....#..#.....#..#..#..#..#...........#..............#.....#..#..#..#...........#
#..#..#..#######..#######..####..##########..#######..#..##########..####..#..####..####..#
#..#........#........#.....#.................#........#.....#..#..#..#..#...........#.....#
#######..#######..#..####..#######..################..#######..#..#..#..#..####..#######..#
#...........#..#..#..#..............#...........#..#..#..#..#...........#..#..#..#........#
#..##########..#..##########..####..####..####..#..#..#..#..#..##########..#..##########..#
#.................#.....#..#.....#.....#.....#..#..............#.....#..#..#.....#..#.....#
#..##########..#..#..####..#..#..#..####..####..#..#..#######..#..####..#######..#..####..#
#.....#..#.....#..#.....#.....#..#.....#..#..#..#..#........#..#....................#..#..#
#..####..#..#..#######..###################..#..#..##########..#..#############..#..#..#..#
#........#..#..............#........#.....#.....#.....#........#.....#..#..#.....#.....#..#
####..#..#..#..#######..#..#..##########..#..#..#######..##########..#..#..#..##########..#
#.....#..#..#.....#.....#.....#.....#.....#..#..#...........#.....#..#....................#
#..####..####..#..##########..#..#######..#..#..#..#..####..#..#..####..#..####..#######..#
#.....#.....#..#.....#....................#..#.....#..#........#.....#..#..#...........#..
########################################################################################..